1111111111111111111111111111111111111111111111111111111
1000000000000000000000000000010000000000000000000000011
1011111111111110111111111111010111100011111111111111011
1000000000100000100010001001C10000110100000000000000011
1110111110101111101010101010101110110101111111111111111
111C111110100000001000000000000000110111000000000000001
1111111110111111111111111111111111110111011111111111101
1P00000C00000000000000000000001111110111010000000C11101
11111111111111111110111111111110000000C1010111110100001
1000000000000000000001C00111111011110111010111110101101
1011111111111110111011101000000001110101010111110101101
10000000000001101110000010111111100001010001111101011C1
1111111111111110111111111011100011111101111111110101111
1110C00000000000000000001000001000000000000000000100111
1111111111011111111111111111111111111111111111111110111
1000000000000000000000000000010000001000000000000000011
1011111111111110111111111111010111101011111111111111001
1000000000100000111000000000000011010000000000000001111
1110111110101111111111111111111110110101111111111111111
111C111110100000000000000000000000110111000000000000001
1111111110111111111111111111111111110111011111111111101
1000000C00100000000000000000000011110111010000000000001
1111111111111111111011111111111000000001010111110100001
1000000000000000000001000111111011110111010100010101101
1011111111111110111011101000000001110111010111010101101
10000000000001101110000010111111100000010000000101011C1
1111111111111110111111111011111111111111111111110101011
1E00000000000000000000001000000000000000000000000100011
1111111111111111111111111111111111111111111111111111111