111111
1P00C1
101101
1C00E1
111111