111111
1EP001
1C0111
1001C1
111111