111111
10P001
1C0011
100EC1
111111