111111
1EP001
1C0111
1000C1
111111