1111
1EP1
1C01
1111
1111
1111
1111
1111
1001
1111