111111111
1CPE00001
1C0001001
111111111
