111111
1CP0C1
1C0011
100EC1
111111