11111111
10E1P001
10011101
1CC0C001
1CC00001
11111111