1111111111111
1001C01111101
1000011111001
1PE0110000001
1111111111111