1111011111111
10010C0000E11
10000111111
1P001111
11111