1111CC1111111
10010000000CC
1000011111001
1P0011E000001
1111111111111